                                                            
                                                            
  $###############################                          
   #####  ####  #     #################################     
   ############ #                #      #     ##########    
   ##  ######## #                $      #        ######     
   #      ##    ################################ ######     
  ## ####### ###################################  #####     
  #  ###### #####        ######################## #####     
  #  ######  ####         ####################### #####     
  #  ######  ####         #######################     #     
  #  ###############################################  #     
  ####### #     #    #########   #      #  ##   ####  #     
  #       ########################      #  ##   #     #     
  #########     #                #      #  ##   #     #     
  #########     #                #######   ##   #######     
  #       ###############   ######         ##   #     #     
  ## ############       #   #    #         ##   #     #     
  #       #     #       #####    #####     ##   #     #     
  # #######     #       #        #######################    
  #    ###############################    #     #    ##     
  # ######       #       #       #####    #     #    ##     
  ########  ###  #       #   ##########   #     #    ##     
  #  #####    #  ##################       #     #    ##     
 ### #####    #  #       #                #     #    ##     
  ## #####    #  #       ########################   ###     
  # ###################################################     
 ##  #####       #            ##                #           
    #############################################           
