                                                            
                                                            
  ###############################################           
     #       #          #####           #                   
     #       #          #####           #                   
     #       #            ###########   #                   
     #       ############               #                 
     #       #                          #                   
     #########        #######           #                   
        #             #     #           #                   
        #     ###########   #           #                   
        #    ######    #    #           #                   
        ###########    #    #           #                   
        #              #    #           ######$             
        #        #######    #           #    #              
        #        ###        #           #    #              
        #        ###        ##################              
        ############                                        
                                                            
                                                            
