                                                            
                                                            
  ###############################################           
     #       #                          #                   
     #       #                          #                   
     #       #                          #                   
     #       ##############             #                   
     #       #                          #                   
     #########        #######           #                   
        #             #     #           #                   
        #     ###########   #           #                   
        #    ######    #    #           #                   
        ###########    #    #           #                   
        #              #    #           ######$             
        #          #####    #           #    #              
        #          #        #           #    #              
        #          #        ##################              
        ############                                        
                                                            
                                                            
