                                                                                
 ##################################################                             
   #     #      #                  #                                            
   #     #      #                  #                                            
   #     ########                  #                                            
   #     #       ####              #                                            
   #     #          #              #      ################################      
   #     #          #              #           #                        ##      
   ##################################          #                         #      
   #                #              ##          #                         #      
   #                #              ##          #                         #      
   #       #        #              ##          #                         #      
   #  ######        #              ##          #                         #      
   #   #   ##########              #####$###################             #      
   #   #            #              ##                 #                  #      
   #   #            #                                 #                  #      
   #   ####         #                                 #                  #      
   #   ####         ######################################################      
   #   ####         #                     #           #                         
   #   ####         #                     #           #                         
   #   ####         #                     #           #                         
   ####################################################                         
                                                                                
                                                                                
                                                                                
                                                                                
